10 4 4 4 4 4 4 4 4 4 4 4 4 4 4 4 4 4 4 4 4 4 4 4 4 4 4 4 4 4 4 4 4 4 4 4 4 4 4 11 
5 0 0 0 0 0 0 0 0 0 0 0 0 0 0 0 0 0 0 0 0 0 0 0 0 0 0 0 0 0 0 0 0 0 0 0 0 0 0 5 
5 0 10 4 4 4 4 4 4 4 4 4 4 4 4 4 4 4 4 4 4 4 4 4 4 4 4 4 4 4 4 4 4 0 0 0 0 0 0 5 
5 0 5 0 0 0 0 0 0 0 0 0 0 0 0 0 0 0 0 0 0 0 0 0 0 0 0 0 0 0 0 0 0 0 0 0 0 0 0 5
5 0 5 0 14 7 7 7 7 7 15 0 10 4 4 4 4 4 4 4 4 4 4 4 4 4 4 4 4 4 4 20 0 0 0 0 0 0 0 5 
5 0 5 0 8 22 22 22 22 22 9 0 5 0 0 0 0 0 0 0 0 0 0 0 0 0 0 0 0 0 0 0 0 0 0 0 0 0 0 5
12 4 13 0 8 22 22 22 22 22 9 0 5 0 0 0 0 0 0 0 0 0 10 4 4 4 4 4 0 0 0 0 0 0 0 0 0 0 0 5
0 0 0 0 8 22 22 22 22 22 9 0 5 0 0 0 0 0 0 0 0 0 5 0 0 0 0 0 0 0 0 0 0 0 0 0 0 0 0 5
10 4 4 20 8 22 22 22 22 22 9 0 18 0 0 0 0 0 0 0 0 0 5 0 10 4 4 4 4 4 0 0 0 0 0 0 0 0 0 5 
5 0 0 0 16 6 6 6 6 6 17 0 0 0 0 0 0 0 0 0 0 0 5 0 5 0 0 0 0 0 0 0 0 0 0 0 0 0 0 5
5 0 0 0 0 0 0 0 0 0 0 0 0 10 4 4 4 4 4 4 20 0 5 0 5 0 0 0 0 0 0 0 0 0 0 0 0 0 0 5
5 0 10 4 11 0 10 4 4 4 4 11 0 5 0 0 0 0 0 0 0 0 5 0 5 0 0 0 0 0 0 0 0 0 0 0 0 0 0 5
5 0 5 0 5 0 5 0 0 0 0 5 0 5 0 21 4 4 4 4 4 4 13 0 12 11 0 0 0 0 0 0 0 0 0 0 0 0 0 5
5 0 5 0 5 0 12 4 4 11 0 5 0 5 0 0 0 0 0 0 0 0 0 0 0 5 0 0 0 0 0 0 0 0 0 0 0 0 0 5
5 0 5 0 5 0 0 0 0 5 0 18 0 5 0 0 14 15 0 14 7 7 7 15 0 5 0 0 0 0 0 0 0 0 0 0 0 0 0 5
5 0 5 0 12 4 4 20 0 5 0 0 0 18 0 0 16 17 0 16 6 6 6 17 0 5 0 0 0 0 0 0 0 0 0 0 0 0 0 5
5 0 5 0 0 0 0 0 0 5 0 19 0 0 0 0 0 0 0 0 0 0 0 0 0 5 0 0 0 0 0 0 0 0 0 0 0 0 0 5 
5 0 5 0 19 0 0 0 0 5 0 5 0 19 0 0 0 10 4 4 4 4 4 11 0 18 0 0 0 0 0 0 0 0 0 0 0 0 0 5
5 0 5 0 12 4 4 4 4 13 0 5 0 5 0 19 0 5 0 0 0 0 0 5 0 0 0 0 0 0 0 0 0 0 0 0 0 0 0 5
5 0 5 0 0 0 0 0 0 0 0 5 0 5 0 5 0 5 0 0 0 0 0 5 0 21 4 11 0 0 0 0 0 0 0 0 0 0 0 5
5 0 5 0 21 4 4 4 4 4 4 13 0 5 0 5 0 5 0 0 0 0 0 5 0 0 0 5 0 0 0 0 0 0 0 0 0 0 0 5
5 0 5 0 0 0 0 0 0 0 0 0 0 5 0 5 0 12 4 11 0 10 4 13 0 19 0 5 0 0 0 0 0 0 0 14 7 15 0 5 
5 0 5 0 0 0 0 0 0 0 4 4 4 13 0 18 0 0 0 5 0 5 0 0 0 5 0 5 0 0 0 0 0 0 0 8 22 9 0 5
5 0 5 0 0 0 0 0 0 0 0 0 0 0 0 0 0 0 0 5 0 5 0 0 0 5 0 5 0 14 7 7 7 15 0 8 22 9 0 5
5 0 5 0 0 0 0 0 0 14 7 7 7 7 15 0 0 0 0 5 0 12 4 4 4 13 0 18 0 16 6 6 6 17 0 16 6 17 0 5
5 0 5 0 0 0 0 0 0 8 22 22 22 22 9 0 0 0 0 5 0 0 0 0 0 0 0 0 0 0 0 0 0 0 0 0 0 0 0 5
5 0 5 0 0 0 0 0 0 16 6 6 6 6 17 0 0 0 0 12 4 4 4 4 4 4 4 4 4 11 0 0 10 4 4 4 4 20 0 5 
5 0 5 0 0 0 0 0 0 0 0 0 0 0 0 0 0 0 0 0 0 0 0 0 0 0 0 0 0 5 0 0 5 0 0 0 0 0 0 5
5 0 5 0 0 0 0 0 0 0 0 0 0 0 0 0 0 0 0 0 0 0 0 0 0 0 0 0 10 13 0 0 12 4 4 4 4 11 0 5
5 0 18 0 0 0 0 0 0 0 0 0 0 0 0 0 0 0 0 0 0 0 0 0 0 0 0 0 5 0 0 0 0 0 0 0 0 5 0 5
5 0 0 0 0 0 0 0 0 0 0 0 0 0 0 0 0 0 0 0 0 0 0 0 0 0 0 0 5 0 0 0 0 0 0 0 0 5 0 5
5 0 21 4 4 4 4 20 0 21 4 4 4 4 4 4 20 0 21 4 4 4 4 4 4 4 20 0 5 0 0 0 0 0 0 0 0 5 0 5 
5 0 0 0 0 0 0 0 0 0 0 0 0 0 0 0 0 0 0 0 0 0 0 0 0 0 0 0 5 0 0 0 0 0 0 0 0 5 0 5
5 0 21 4 4 4 4 4 4 20 0 21 4 4 4 4 4 4 4 4 20 0 21 4 4 4 20 0 5 0 0 0 0 0 0 0 0 5 0 5
5 0 0 0 0 0 0 0 0 0 0 0 0 0 0 0 0 0 0 0 0 0 0 0 0 0 0 0 5 0 0 0 0 0 0 0 0 5 0 5
5 0 21 4 20 0 21 4 4 4 4 4 4 20 0 0 0 0 14 7 7 7 7 7 7 7 15 0 5 0 0 0 0 0 0 0 0 5 0 5
5 0 0 0 0 0 0 0 0 0 0 0 0 0 0 0 0 0 8 22 22 22 22 22 22 22 9 0 5 0 0 0 0 0 0 0 0 5 0 5 
5 0 21 4 4 4 4 4 4 20 0 0 0 0 0 0 0 0 16 6 6 6 6 6 6 6 17 0 12 4 4 4 4 4 4 4 4 13 0 5
5 0 0 0 0 0 0 0 0 0 0 0 0 0 0 0 0 0 0 0 0 0 0 0 0 0 0 0 0 0 0 0 0 0 0 0 0 0 0 5
12 4 4 4 4 4 4 4 4 4 4 4 4 4 4 4 4 4 4 4 4 4 4 4 4 4 4 4 4 4 4 4 4 4 4 4 4 4 4 13 


        